34 19
0 0 0 0 0 0 0 0 0 0 0 0  0 0 0 0 0 0 0 0  0 0 0 0 0 0  0 0 0 0 0 0 0  0
0 1 1 1 1 1 1 1 1 1 1 1  1 1 1 1 1 1 1 1  1 1 1 1 1 1  1 1 1 1 1 1 1  0
0 1 1 1 1 1 1 1 1 1 1 1  1 1 1 1 1 1 1 1  1 1 1 1 1 1  1 1 1 1 1 1 1  0
0 1 1 1 1 1 1 1 1 1 1 1  1 1 1 1 1 1 1 1  1 1 1 1 1 1  1 1 1 1 1 1 1  0
0 1 1 1 1 1 1 1 1 1 1 1  1 1 1 1 1 1 1 1  1 1 1 1 1 1  1 1 1 1 1 1 1  0
0 1 1 1 2 2 2 2 2 1 1 1  1 1 1 1 1 1 1 1  1 1 1 1 1 1  1 1 1 1 1 1 1  0
0 1 1 1 2 4 4 4 2 1 6 1  1 1 6 1 1 1 1 1  1 1 1 1 1 1  1 1 1 1 1 1 1  0
0 1 1 1 2 4 4 4 4 8 4 10 1 1 5 1 1 1 1 1  1 1 1 1 1 1  1 1 1 1 1 1 1  0
0 1 1 1 2 4 13 4 0 4 2 1 5 1  1 1 5 1 1 2 2 2  2 2 1 1 1 1  1 1 1 1 1 1 1  0
0 1 1 1 2 2 2 2 2 1 4 8  8 8 4 8 8 8 8 10 1 2 1 1 6 1  1 1 1 1 1 1 1  0
0 1 1 1 1 1 1 1 1 1 5 1  1 1 5 1 1 2 2 2  1 2 1 1 5 1  1 1 1 1 1 1 1  0
0 1 1 1 1 1 1 1 1 1 5 1  1 1 5 1 1 1 1 2  1 2 1 1 5 1  1 1 1 6 1 1 1  0
0 1 1 1 1 1 1 1 1 9 4 10 1 1 5 1 1 1 1 2  2 2 1 9 4 8  8 8 8 4 8 8 10 0
0 1 1 1 1 1 1 1 1 1 7 1  1 1 5 1 1 1 1 1  1 1 1 1 5 1  1 1 1 5 1 1 1  0
0 1 1 1 1 1 1 1 1 1 1 1  1 9 4 8 8 8 8 8  8 8 8 8 4 10 1 2 2 3 1 1 2  2 1 0
0 1 1 1 1 1 1 1 1 1 1 1  1 1 7 1 1 1 1 1  1 1 1 1 7 1  1 2 2 2 2 2 1  0
0 1 1 1 1 1 1 1 1 1 1 1  1 1 1 1 1 1 1 1  1 1 1 1 1 1  1 2 2 2 2 2 1  0
0 1 1 1 1 1 1 1 1 1 1 1  1 1 1 1 1 1 1 1  1 1 1 1 1 1  1 1 1 1 1 1 1  0
0 0 0 0 0 0 0 0 0 0 0 0  0 0 0 0 0 0 0 0  0 0 0 0 0 0  0 0 0 0 0 0 0  0
