10 8
11 2 2 2 2 2 2 2 2 11
11 2 2 2 14 2 3 2 2 2 2 11
11 12 12 12 12 12 12 12 12 11
11 12 12 12 12 12 12 12 12 11
11 12 12 12 12 12 12 12 12 11
11 12 12 12 12 12 12 12 12 11
11 12 12 12 12 12 13 12 0 12 12 11
11 11 11 11 11 11 11 11 11 11